R          1920          1080



NO       ./path_to_the_north_texture.xpm


SO       ./path_to_the_south_texture.xpm
WE            ./path_to_the_west_texture.xpm

S                ./path_to_the_sprite_texture.xpm
C 225,     30            ,0


F    220,           100,0

EA    ./path_to_the_east_texture.xpm

               1111111111111111111111111    111111111
               1000000000110000000000000001   1000001
               1011000001110000001 1200001  111111111
               100100000000000000000000001
        1111111110110000011100000000000011
       1100000000011000001110111111111111      N
    111100000111111111011100000010001
1111110000000000000000011101010010001
  11110000000110101011100000010001
  111100020000000000011000000100011
     1110000000000000001101010010001111111
        110000011101010111110111100000000111
        11110111 1110101 101111010001111111
        11111111 1111111 11111111111111

