R          1920          1080



NO       ./path_to_the_north_texture.xpm


SO       ./path_to_the_south_texture.xpm
WE            ./path_to_the_west_texture.xpm

EA    ./path_to_the_east_texture.xpm
S                ./path_to_the_sprite_texture.xpm


F    220,           100,0

C 225,     30            ,0



        1111111111111111111111111    111111111
        10000000001100000000000011    1000001
        101100000111000000200000001  111111111
        100100000000000000000000001
1111111110110000011100000000000011
100000000011000001110111111111111          N
11110111111111011100000010001
11110111111111011101010010001
11000000110101011100000010001
10002000000000001100000010001
10000000000000001101010010001111111
110000011101010111110111100000000111
11110111 1110101 101111010001
11111111 1111111 111111111111