


   R 1908 751



NO       ./path_to_the_north_texture.xpm


SO       ./path_to_the_south_texture.xpm
WE            ./path_to_the_west_texture.xpm

S             ./path_to_the_sprite_texture.xpm

C  255, 4, 8


F    220,           100,7

EA ./path_to_the_east_texture.xpm

             1111111111111111111111111
             1000000001100000000000001
             1011000001110000000000001
             1001000000000000000000001
     111111111011000001110000000000001
     100000000110000011101111111111111
     1110111111111011100000010001
     11110111111111011101010010001
  111110000001101010111000000100001111111
 1000000200000000000110000001000000110101
 1000000000000000000110101001N00000011
 111000001110001011111011110000000111
   1111110111 1110101 1011110100000001
     1111111 1111111 11111111111111111

