R          1920          1080

NO       ./path_to_the_north_texture
SO                      ./path_to_the_south_texture
WE            ./path_to_the_west_texture
EA    ./path_to_the_east_texture

S ./path_to_the_sprite_texture

F    220,           100,0
C 225,30            ,0

111111111111111111111111111
100000000000000000000000001
100000000000000000000000001
100000011100000011100000001
10000001 10000001 100000001
10000001 10000001 100000001
10000001 10000001 100000001
11111111 11111111 111111111
