   R 1908 75
   EA ./path_to_the_east_texture.xpm
NO ./path_to_the_north_texture.xpm
 awedwqdwSO       ./path_to_the_south_texture.xpm
WE            ./path_to_the_west_texture.xpm
C  255, 4, 8


S             ./path_to_the_sprite_texture.xpm

F    220,           100,7

              111111111111111111111111
             1111111111111111111111111
             1000000001100000000000001
             10110N0001110000000000001
             1111111111111111111111111
     111111111011000001110000000000001
     100000000110000011101111111111111
     1110111111110111000000100011111
     11110111111111011101010010001
11111100000011010101110000001000011111
10000002000000000001100000010000001101
 100000000000000000011010100100000011
 111000001110001011111011110000000111
   111111011111110101 1011110100000001
     1111111 1111111 1111111111111111
