 R 600 750
 EA ./texture/brick_wall.xpm
 NO ./path_to_the_north_texture.xpm
 SO ./path_to_the_south_texture.xpm
C 255,97,8
 WE ./path_to_the_west_texture.xpm
 S  ./path_to_the_sprite_texture.xpm
F  7, 50 ,                9
              1111111111111111111111111
             1000000001100000000000001
             101100001110000000000001
             11111111111111111111111111
     1111111110110000011100000000000N01
     1000000001100000111011111111111111
     1110111111110111000000100011111
     11110111111111011101010010001
11111100000011010101110000001000011111
10000002000000000001100000010000001101
 100000000000000000011010100100000011
 111000001110001011111011110000000111
   111111011111110101 1011110100000001
     1111111 1111111 1111111111111111
