 R 1000 600
 EA ./texture/brick_wall.xpm
 NO ./path_to_the_north_texture.xpm
 SO ./path_to_the_south_texture.xpm
C 80,150,230
 WE ./path_to_the_west_texture.xpm
 S  ./path_to_the_sprite_texture.xpm
F  60, 230 ,                150

11111111111111
10000000000001
10000000110001
10000000110001
10000000000001
10000000000N01
10000000000001
10000000011111
10000000011111
10000000000001
10000000000001
11111111111111
