 R 1000 600
 EA ./texture/brick_wall.xpm
 NO ./path_to_the_north_texture.xpm
 SO ./path_to_the_south_texture.xpm
C 80,150,230
 WE ./path_to_the_west_texture.xpm
 S  ./path_to_the_sprite_texture.xpm
F  60, 230 ,                150

              1111111111111111111111111
              1000000001100000000000001
              1011000001110000000000001
              1001000000000000000000001
      111111111011000001110000000000001
      100000000110000011101111111111111
      1110111111111011100000010001
      11110111111111011101010010001
   111110000001101010111000000100001111111
  100000020000000000011000000100000011011
  1000000000000000000110101001N00000011
  111000001110001011111011110000000111
    111111011111110101 1011110100000001
      1111111 1111111 11111111111111111